............
............
............
............
............
............
............
............
............
............
............
............
............
............
.....oo.....
....o..o....
...oo..oo...
...oo..oo...
...o.oo.o...
.....oo.....
...o....o...
..oo....oo..
............
............
.....oo.....
....o..o....
....o..o....
............
............
