........
........
..o.....
...oo...
..oo....
........
........
........
